gwas_id	trait	combined
070.2	Viral_hepatitis_B	Viral_hepatitis
070	Viral_hepatitis	Viral_hepatitis
151	Cancer_of_stomach	Cancer_of_stomach
153.2	Colon_cancer	Colorectal_cancer
153	Colorectal_cancer	Colorectal_cancer
165.1	Cancer_of_bronchus;_lung	Cancer_of_bronchus;_lung
174.1	Breast_cancer_female	Breast_cancer
174.11	Malignant_neoplasm_of_female_breast	Breast_cancer
174	Breast_cancer	Breast_cancer
185	Prostate_cancer	Prostate_cancer
193	Thyroid_cancer	Thyroid_cancer
218.1	Uterine_leiomyoma	Uterine_leiomyoma
218	Benign_neoplasm_of_uterus	Uterine_leiomyoma
241	Nontoxic_nodular_goiter	Nontoxic_nodular_goiter
242	Thyrotoxicosis_with_or_without_goiter	Thyrotoxicosis_with_or_without_goiter
250.2	Type_2_diabetes	Diabetes_mellitus
250.21	Type_2_diabetes_with_ketoacidosis	Diabetes_mellitus
250.22	Type_2_diabetes_with_renal_manifestations	Diabetes_mellitus
250.23	Type_2_diabetes_with_ophthalmic_manifestations	Diabetes_mellitus
250.24	Type_2_diabetes_with_nervous_system_manifestations	Diabetes_mellitus
250.25	Diabetes_type_2_with_peripheral_circulatory_disorders	Diabetes_mellitus
250.6	Polyneuropathy_in_diabetes	Diabetes_mellitus
250	Diabetes_mellitus	Diabetes_mellitus
272.1	Hyperlipidemia	Hyperlipidemia
272.11	Hypercholesterolemia	Hyperlipidemia
272.13	Mixed_hyperlipidemia	Hyperlipidemia
272.9	Unspecified_disorder_of_lipoid_metabolism	Hyperlipidemia
272	Disorders_of_lipoid_metabolism	Hyperlipidemia
274.1	Gout	Gout
274.11	Gouty_arthropathy	Gout
274	Gout_and_other_crystal_arthropathies	Gout
282	Hereditary_hemolytic_anemias	Hereditary_hemolytic_anemias
317.1	Alcoholism	Alcohol-related_disorders
317	Alcohol-related_disorders	Alcohol-related_disorders
362.2	Degeneration_of_macula_and_posterior_pole_of_retina	Macular_degeneration
362.29	Macular_degeneration_(senile)_of_retina_NOS	Macular_degeneration
386.2	Peripheral_or_central_vertigo	Peripheral_or_central_vertigo
386.21	Central_origin_vertigo	Peripheral_or_central_vertigo
386.3	Labyrinthitis	Peripheral_or_central_vertigo
386.9	Dizziness_and_giddiness_(Light-headedness_and_vertigo)	Peripheral_or_central_vertigo
386	Vertiginous_syndromes_and_other_disorders_of_vestibular_system	Peripheral_or_central_vertigo
401.1	Essential_hypertension	Hypertension
401.2	Hypertensive_heart_and/or_renal_disease	Hypertension
401.21	Hypertensive_heart_disease	Hypertension
401.3	Other_hypertensive_complications	Hypertension
401	Hypertension	Hypertension
411.4	Coronary_atherosclerosis	Coronary_atherosclerosis
427.2	Atrial_fibrillation	Atrial_fibrillation
427.21	Atrial_fibrillation	Atrial_fibrillation
531.3	Duodenal_ulcer	Peptic_ulcer
531	Peptic_ulcer_(excl._esophageal)	Peptic_ulcer
573	Other_disorders_of_liver	Other_disorders_of_liver
575.6	Cholesterolosis_of_gallbladder	Cholelithiasis
594.1	Calculus_of_kidney	Calculus_of_kidney
695.4	Lupus_localized_systemic	SLE
695.42	Systemic_lupus_erythematosus	SLE
695	Erythematous_conditions	SLE
696.4	Psoriasis	Psoriasis
696.41	Psoriasis_vulgaris	Psoriasis
696	Psoriasis_and_related_disorders	Psoriasis
709	Diffuse_diseases_of_connective_tissue	SLE
939	Atopic/contact_dermatitis_due_to_other_or_unspecified	Atopic
947	Urticaria	Urticaria
ALT	Serum_glutamate_pyruvate_transaminase	Serum_ALT
Angina-pectoris	Angina_pectoris	Angina_pectoris
AST	Serum_glutamic_oxaloacetic_transaminase	Serum_AST
Asthma	Asthma	Asthma
Asthma-Zhou-W-Cell-Genom	Asthma	Asthma
Atopic-dermatitis	Atopic	Atopic
Atrial-fibrillation	Atrial_fibrillation	Atrial_fibrillation
Basophil-count	Basophil_count	Basophil_count
BMI	BMI	BMI
Body-mass-index	BMI	BMI
Body-mass-index-Akiyama-M-Nat-Genet	BMI	BMI
Breast-cancer	BRCA	Breast_cancer
Brugada-syndrome-Ishikawa-T-Eur-Heart-J	Brugada_syndrome	Brugada_syndrome
BUN	Blood_urea_nitrogen	Blood_urea_nitrogen
CD-EAS-Liu2023NG	Crohns_disease	Crohns_disease
Cholelithiasis	Cholelithiasis	Cholelithiasis
Chronic-obstructive-pulmonary-disease-Zhou-W-Cell-Genom	COPD	COPD
Comorbidity-of-gastric-and-duodenal-ulcers-He-Y-Nat-Genet	Comorbidity_of_gastric_and_duodenal_ulcers	Peptic_ulcer
DBP	Diastolic_blood_pressure	Diastolic_blood_pressure
Duodenal-ulcer-He-Y-Nat-Genet	Duodenal_ulcer	Peptic_ulcer
Eosinophil-counts	Eosinophil_count	Eosinophil_count
Esophageal-cancer	Esophageal	Esophageal
FG	Fasting_glucose	Fasting_glucose
Gastric-cancer	Gastric_cancer	Gastric_cancer
Gastric-ulcer-He-Y-Nat-Genet	Gastric_ulcer	Peptic_ulcer
Glaucoma-Zhou-W-Cell-Genom	Glaucoma	Glaucoma
Gout-Major-TJ-Nat-Genet	Gout	Gout
Gout-Zhou-W-Cell-Genom	Gout	Gout
Graves-disease	Graves'_disease	Graves'_disease
HB	Hemoglobin	Hemoglobin
HbA1c	Glycated_hemoglobin	Glycated_hemoglobin
HCT	Hematocrit	Hematocrit
HDL-C	HDLC	HDLC
Hematocrit	Hematocrit	Hematocrit
Hemoglobin-A1c-levels	Glycated_hemoglobin	Glycated_hemoglobin
HR	Heart_rate	Heart_rate
HT	Height	Height
IBD-EAS-Liu2023NG	Inflammatory_bowel_disease	IBD
LDL-C	LDLC	LDLC
Lymphocyte-count	LCL_count	LCL_count
MAP	Mean_arterial_pressure	Mean_arterial_pressure
Mean-corpuscular-hemoglobin	MCH	MCH
Mean-corpuscular-hemoglobin-concentration	MCH_concentration	MCH
Mean-corpuscular-volume	Mean_corpuscular_volume	Mean_corpuscular_volume
Monocyte-count	Monocyte_count	Monocyte_count
Myocardial-infarction	Myocardial_Infraction	Myocardial Infraction
Neutrophil-count	Neutrophil_count	Neutrophil_count
Parkinsons-disease-Park-KW-NPJ-Parkinsons-Dis	Parkinsons_disease	Parkinsons_disease
Peptic-ulcer-disease-He-Y-Nat-Genet	Peptic_ulcer	Peptic_ulcer
Platelet-count	Platelet_count	Platelet_count
PLT	Platelet_count	Platelet_count
PP	Pulse_pressure	Pulse_pressure
Prostate-cancer	Prostate_cancer	Prostate_cancer
Prostate-cancer-Ito-S-Nat-Commun	Prostate_cancer	Prostate_cancer
Prostate-cancer-Wang-A-Nat-Genet	Prostate_cancer	Prostate_cancer
RBC	RBC	RBC
Red-blood-cell-count	RBC	RBC
Rheumatoid-arthritis	Rheumatoid_arthritis	Rheumatoid_arthritis
SBP	Systolic_blood_pressure	Systolic_blood_pressure
sCR	Serum_creatinine	Serum_creatinine
Stable-angina-pectoris	Stable_Angina	Stable_Angina
Stroke-Mishra-A-Nature	Stroke	Stroke
T-BIL	Total_bilirubin	Total_bilirubin
TC	Total_cholesterol	Total_cholesterol
TG	Triglycerides	Triglycerides
Type-2-diabetes	Type_2_diabetes	Diabetes_mellitus
Type-2-diabetes-Spracklen-CN-Nature	Type_2_diabetes	Diabetes_mellitus
UA	Uric_acid	Uric_acid
UC-EAS-Liu2023NG	Ulcerative_colitis	Ulcerative_colitis
Urolithiasis	Urolithiasis	Urolithiasis
Uterine-fibroids	Uterine_fibroids	Uterine_leiomyoma
WBC	WBC	WBC
Weight	Weight	Weight
T2D	T2D	Type_2_diabetes
CD	CD	Crohns_disease
Graves	Graves	Graves' disease
IBD	IBD	IBD
Stable_angina_pectoris	Stable_angina_pectoris	Stable_Angina
UC	UC	UC
Stroke-Zhou-W-Cell-Genom	Stroke	Stroke
150	Cancer of esophagus	Esophageal
153.3	Malignant neoplasm of rectum, rectosigmoid junction, and anus	Colorectal_cancer
199	Neoplasm of uncertain behavior	Neoplasm of uncertain behavior
225	Benign neoplasm of brain and other parts of nervous system	Benign neoplasm of brain
240	Simple and unspecified goiter	Simple and unspecified goiter
242.1	Graves' disease	Graves' disease
244	Hypothyroidism	Hypothyroidism
244.4	Hypothyroidism NOS	Hypothyroidism
250.7	Diabetic retinopathy	Diabetes_mellitus
251	disorders_of_pancreatic_internal_secretion	disorders_of_pancreatic_internal_secretion
277	Other disorders of metabolism	Other disorders of metabolism
277.2	Other disorders of purine and pyrimidine metabolism	Other disorders of metabolism
278	Overweight, obesity and other hyperalimentation	Obesity
278.1	Obesity	Obesity
340	Migraine	Migraine
362	Other retinal disorders	Other retinal disorders
370	Keratitis	Keratitis
411.2	Myocardial infarction	Myocardial Infraction
472	Chronic pharyngitis and nasopharyngitis	Chronic pharyngitis and nasopharyngitis
476	Allergic rhinitis	Allergic rhinitis
573.7	Abnormal results of function study of liver	Other_disorders_of_liver
574	Cholelithiasis and cholecystitis	Cholelithiasis
574.1	Cholelithiasis	Cholelithiasis
580.3	Nephritis and nephropathy without mention of glomerulonephritis	Nephritis and nephropathy
580.31	Nephritis and nephropathy in diseases classified elsewhere	Nephritis and nephropathy
580.32	Nephritis and nephropathy with pathological lesion	Nephritis and nephropathy
585	Renal_failure	Renal_failure
585.3	Chronic renal failure [CKD]	Renal_failure
585.33	Chronic Kidney Disease, Stage III	Renal_failure
586	Other disorders of the kidney and ureters	Other disorders of the kidney and ureters
594	Urinary_calculus	Urinary_calculus
594.3	Calculus of ureter	Urinary_calculus
595	Hydronephrosis	Hydronephrosis
599.2	Retention of urine	Retention of urine
600	Hyperplasia of prostate	Hyperplasia of prostate
613	Other nonmalignant breast conditions	Other nonmalignant breast conditions
681.1	Cellulitis and abscess of fingers/toes	Cellulitis and abscess of fingers/toes
709.2	Sicca_syndrome	Sicca_syndrome
790	Nonspecific findings on examination of blood	Other abnormal blood chemistry
790.6	Other abnormal blood chemistry	Other abnormal blood chemistry
Colorectal-cancer	Colorectal_cancer	Colorectal_cancer
